........................................................................................................................................................................................................................................................................................
........................................................................................................................................................................................................................................................................................
........................................................................................................................................................................................................................................................................................
........C.................C.....................................................C................C....................................................C..........................................................................C......................................................
......#####.............#####.................................................#####............#####.................................................###........................................................................###.....................................................
P...................E.....................................................................E.............................................................................................................................................................................................
##########..................................................##########............................................................##########............................................................##########............................................................##########
........................................................................................................................................................................................................................................................................................
............###############.....................................................###############...............###############...........................######..........######..........######..............................########################################....................
........................................................................................................................................................................................................................................................................................
........##########...............................................................############.............................................................##############...........................................................################.....................................
......................................................................................................................................................................................................................................................................................G.
##############################################################################################################################################################################################################################################################################........##