........................................................................................................................................................................................................................................................................................
........................................................................................................................................................................................................................................................................................
............................................................................................................S...........................................................................................................................................................................
...............C.........C....................................................C.................C........#######......................................C................C....................................................C...........C...............................................
..............###.......###.................................................#####.............#####.................................................#####............#####.................................................###.........###..............................................
P...................E.....................................................................E.....................................................................E.......................................................................................................................
##########..................................................##########............................................................##########............................................................##########............................................................##########
........................................................................................................................................................................................................................................................................................
..........########################################.....................................###############................................................###############...............###############...........................######..........######..........######....................
........................................................................................................................................................................................................................................................................................
........##^#######...............................................................############.............................................................##############...........................................................################.....................................
......................................................................................................................................................................................................................................................................................G.
##############################################################################################################################################################################################################################################################################........##