......................................................................
......................................................................
......................................................................
..........C.........C.........C.........C.............................
.........###.......###.......###.......###............................
P...................E..............E..................................
##########..................................................##########
......................................................................
............................##########................................
......................................................................
......................................................................
.....................................................................F
##############################################################.......#